NO ./resources/xpm/grass.xpm
SO ./resources/xpm/grass.xpm
EA ./resources/xpm/grass.xpm
WE ./resources/xpm/grass.xpm

DO ./resources/xpm/door_tex.xpm
OD ./resources/xpm/dooropen_tex.xpm

C 25,16,25
F 72,60,61


111111111111111111111111111111111111
110000000000000111111111100000000001
100000000000010000111111100000000001
100000000000010000000000000000000001
1110000000D0011111111111100000000001
1110000000000T1111111111100000000001
1111111D1111111111111111111111111111
1111111D1111000000000110000000000001
111111T01111000000000T10111111111101
111111101111000000000110100000000101
11111110T111000000000110101111110101
111111T01111000000000110101000010101
111111100000000000000110101111010101
1111111T1111000000000T10100000010101
111100000001000000000110111111110101
11110010000T0000001D1110000000010101
111100100001111T11101111111111010001
111100000000000000000000000000011111
111111111111111111111111111111111111
