NO ./resources/xpm/moon_tile.xpm
SO ./resources/xpm/moon_tile.xpm
EA ./resources/xpm/moon_tile.xpm
WE ./resources/xpm/moon_tile.xpm

DO ./resources/xpm/ap_door.xpm
OD ./resources/xpm/ap_door_open.xpm

SK ./resources/xpm/ap_sky.xpm
F ./resources/xpm/metal_grid.xpm

S_f ./resources/xpm/fire_set.xpm 1
S_c ./resources/xpm/chesttex.xpm 0
S_w ./resources/xpm/fire_set.xpm 0
S_r ./resources/xpm/pot.xpm 0
S_d ./resources/xpm/mirror.xpm 0
S_u ./resources/xpm/walltex.xpm 0
S_p ./resources/xpm/skytex.xpm 1
S_i ./resources/xpm/torch_set_inter.xpm 0

111111111111111111111111111111
100000000000000000S00000000001
100000000000000000000000000001
100000000000000000000000000001111
100000000000000000000000000000001
1111111111111D1111111111111111111
111111111111101111111111111111111
111111111111101111111111111111111
1111111111111D1111111111111111111
100000000000000000000000000000001
100000000000000000000000000000001
100000000000000000000000000000001
111111111111111111111111111111111

