NO ./resources/xpm/moon_tile.xpm
SO ./resources/xpm/moon_tile.xpm
EA ./resources/xpm/moon_tile.xpm
WE ./resources/xpm/moon_tile.xpm

DO ./resources/xpm/ap_door.xpm
OD ./resources/xpm/ap_door_open.xpm

SK ./resources/xpm/ap_sky.xpm
F ./resources/xpm/metal_grid.xpm

S_c ./resources/xpm/aperture/cube.xpm 0
S_p ./resources/xpm/strip/pole.xpm 1

111111111111111111111111111111
1p0000000000000000S0000000p001
100000c0000000000000000000001
100000000000000000000000000001111
1p000000000000000000000000p000001
1111111111111D1111111111111111111
111111111111101111111111111111111
111111111111101111111111111111111
1111111111111D1111111111111111111
100000000000000000000000000000001
10p00000c000000000000000000000p01
100000000000000000000000000000001
111111111111111111111111111111111

