NO ./resources/xpm/walltex.xpm
SO ./resources/xpm/walltex.xpm
EA ./resources/xpm/walltex.xpm
WE ./resources/xpm/walltex.xpm

DO ./resources/xpm/doortex.xpm
OD ./resources/xpm/doortex_open.xpm

SK ./resources/xpm/skytex.xpm
F ./resources/xpm/floortex.xpm

S_a ./resources/xpm/fire_set.xpm 1
S_c ./resources/xpm/fire_set.xpm 0


111111111111111111111111111111111111
100000000000010000111111100000000001
110000000000000111111111100000000001
100000000000010000000000000000000001        111
10100000D0D0011111111111100000000001       10001
10100O000000011111111111100000000001      1000001
1011111D111111111111111111111111111111111100000001
1011111D111100000000011000000000000000000D00000001
10111110111100000000011011111111110111101100000001
101111101111000000000110100000000101  101 1000001
101111101111000000000110101111110101  101  10001
101111101111000000000110101000010101  101   111
101111100000000000000110101111010101  101
101111111111000000000110100000010101  101                       11111111111111
101100000001000000000110111111110101  1011111111111111111111111110000000000001
1011001000010000001D1110000000010001  10Da0000000000000D00000000c0000000000001
101100100001111111101111111111011111111011111111111111111111111110111110111101
1000000000000000000000ccc0000000000000001                       101   101  101
1000000000000000000000aaa0000000000000N01                       101   101  101
10000000000000000000000000000000000000001                       101   101  101
10000000000000000000000000000000000000001                       101   101  101
10000000000000000000000000000000000000001                       101   101  101
10000000000000000000000000000000000000001                       101   101  101
10000000000000000000000000000000000000001                       101   101  101
10000000000000000000000000000000000000001                       101   101  101
10000000000000000000000000000000000000001                       101   101  101
10000000000000000000000000000000000000001                       101   101  101
10000000000000000000000000000000000000001                       101   101  101
10000000000000000000000000000000000000001                       101   101  101
10000000000000000000000000000000000000001                       101   101  101
10000000000000000000000000000000000000001                       101   101  101
10000000000000000000000000000000000000001                       101   101  101
10000000000000000000000000000000000000001                       101   101  101
10000000000000000000000000000000000000001                       101   101  101
10000000000000000000000000000000000000001                       101   101  101
10000000000000000000000000000000000000001                       101   101  101
10000000000000000000000000000000000000001                       101   101  101
10000000000000000000000000000000000000001                       101   101  101
101111111111111111111111111111111111111111111111111111111111111110111110111101
1000000000000000000aaaaaaaaaaaaaaaa0000000000000000000000000000000000000000001
100000000000000000000000000000000000000000000000000000000000000000000000000001
1000000000000000000aaaaaaaaaaaaaaaa0000000000000000000000000000000000000000001
111111111111111111111111111111111111111111111111111111111111111111111111111111
