NO ./resources/xpm/walltex.xpm
SO ./resources/xpm/walltex.xpm
EA ./resources/xpm/walltex.xpm
WE ./resources/xpm/walltex.xpm

DO ./resources/xpm/doortex.xpm
OD ./resources/xpm/doortex_open.xpm



C 25,16,25
F 72,60,61


111111111111111111111111111111111111
100000000000010000111111100000000001
110000000000000111111111100000000001
100000000000010000000000000000000001        111
10100000D0D0011111111111100000000001       10001
10100O000000011111111111100000000001      1000001
1011111D111111111111111111111111111111111100000001
1011111D111100000000011000000000000000000D00000001
10111110111100000000011011111111110111101100000001
101111101111000000000110100000000101  101 1000001
101111101111000000000110101111110101  101  10001
101111101111000000000110101000010101  101   111
101111100000000000000110101111010101  101
101111111111000000000110100000010101  101                       11111111111111
101100000001000000000110111111110101  101            1111111111110000000000001
1011001000010000001D1110000000010001  101            10D0000000000000000000001
10110010000111111110111111111101111111101            1111111111110111110111101
10000000000000000000000000000000000000001                       101   101  101
10000000000000000000000000000000000000001                       101   101  101
10000000000000000000000000000000000000001                       101   101  101
10000000000000000000000000000000000000001                       101   101  101
10000000000000000000000000000000000000001                       101   101  101
10000000000000000000000000000000000000001                       101   101  101
10000000000000000000000000000000000000001                       101   101  101
10000000000000000000000000000000000000001                       101   101  101
10000000000000000000000000000000000000001                       101   101  101
10000000000000000000000000000000000000001                       101   101  101
1000000000000000000N000000000000000000001                       101   101  101
10000000000000000000000000000000000000001                       101   101  101
10000000000000000000000000000000000000001                       101   101  101
10000000000000000000000000000000000000001                       101   101  101
10000000000000000000000000000000000000001                       101   101  101
10000000000000000000000000000000000000001                       101   101  101
10000000000000000000000000000000000000001                       101   101  101
10000000000000000000000000000000000000001                       101   101  101
10000000000000000000000000000000000000001                       101   101  101
10000000000000000000000000000000000000001                       101   101  101
10000000000000000000000000000000000000001                       101   101  101
101111111111111111111111111111111111111111111111111111111111111110111110111101
100000000000000000000000000000000000000000000000000000000000000000000000000001
111111111111111111111111111111111111111111111111111111111111111111111111111111
