NO ./resources/xpm/walltex.xpm
SO ./resources/xpm/walltex.xpm
EA ./resources/xpm/walltex.xpm
WE ./resources/xpm/walltex.xpm

DO ./resources/xpm/doortex.xpm
OD ./resources/xpm/doortex_open.xpm

SK ./resources/xpm/skytex.xpm
F ./resources/xpm/floortex.xpm

1111111111111111111111111111111
1000000E0000000000000D000111111
1D11111111111111111111110111111
1011111111111111111111110111111
1011111111111111111111110111111
1011111111111111111111110111111
1000000000000000000000000111111
1111111111111111111111111111111
