NO ./resources/xpm/metal_grid.xpm
SO ./resources/xpm/grass.xpm
EA ./resources/xpm/grass.xpm
WE ./resources/xpm/metal_grid.xpm

DO ./resources/xpm/doortex.xpm
OD ./resources/xpm/doortex_open.xpm

SK ./resources/xpm/darksky.xpm
F ./resources/xpm/strip/carpet.xpm

S_d ./resources/xpm/strip/poledancer.xpm 1
S_p ./resources/xpm/strip/pole.xpm 1

111111111111111111111111111111
10000000p0000S00000p0000000001
1000d0000000000000000000d00001
1D000000p0000000000d00000000001111
1000d0000000000000000000p00000001
111111111111101111111111111111111
            101
            101
            101
            101
            101
            101
            101
            101
            101
            101
            101
111111111111101111111111111111111
100000000000000000000000000000001
100000000000000000000000000000001
100000000000000000000000000000001
111111111111111111111111111111111

